1111111111111
10E100C0000C1
1100110111001
1P000C0000001
1111111111111
