11111111111111111111111111111111111111
10000000000C000001E10000000000000000P1
10000000000000000010000000000000000001
11111111111111111111111111111111111111