1111111111
1C0010E111
1P00101111
1100000001
1C000C1111
1111111111