111111111
1C0010E11
1P0010111
110000111
1C000C111
111111111