11111111111111111111111111111111111111
10000000000C000000E00000000000000000P1
11111111111111111111111111111111111111